1111111111111111111111118
0000000000000000000000000
0111111111111111111111111
0000000000000000000000000
1111111111111111111111110
0000000000000000000200020
0111111111111111110304020
0000000000000000010204030
1111111232323110010104010
0000000000009000010004000
#
10 1
7 1
5 2
14 0
100 6
0 50